//MAP CONVERTED BY dmm2tgm.py THIS HEADER COMMENT PREVENTS RECONVERSION, DO NOT REMOVE
"ac" = (
/obj/effect/decal/cleanable/dirt/dust,
/obj/machinery/atmospherics/pipe/simple/supply/hidden/layer2{
	dir = 9
	},
/turf/open/floor/plating,
/area/ship/maintenance/central)
"ba" = (
/obj/structure/flora/ausbushes/ppflowers,
/turf/open/floor/grass,
/area/ship/bridge)
"cd" = (
/obj/effect/turf_decal/corner/opaque/brown{
	dir = 9
	},
/obj/effect/turf_decal/corner/opaque/brown{
	dir = 4
	},
/obj/machinery/button{
	pixel_x = 7;
	pixel_y = 25;
	id = "treepodshutters"
	},
/turf/open/floor/wood,
/area/ship/bridge)
"ce" = (
/obj/effect/turf_decal/corner/opaque/brown{
	dir = 5
	},
/obj/effect/turf_decal/corner/opaque/brown{
	dir = 8
	},
/turf/open/floor/wood,
/area/ship/bridge)
"cN" = (
/obj/structure/flora/ausbushes/brflowers,
/obj/structure/flora/grass/jungle,
/turf/open/floor/grass,
/area/ship/bridge)
"dU" = (
/obj/effect/decal/cleanable/dirt/dust,
/obj/item/trash/can/food/peaches/maint,
/obj/machinery/atmospherics/pipe/manifold/supply/hidden/layer2{
	dir = 1
	},
/turf/open/floor/plating,
/area/ship/maintenance/central)
"fi" = (
/obj/effect/turf_decal/corner/opaque/brown{
	dir = 1
	},
/turf/open/floor/wood,
/area/ship/bridge)
"fK" = (
/turf/open/floor/plating,
/area/space)
"fX" = (
/obj/structure/closet/emcloset/wall{
	pixel_y = 30
	},
/turf/open/floor/plating/catwalk_floor,
/area/space)
"ge" = (
/obj/effect/turf_decal/corner/opaque/brown{
	dir = 6
	},
/obj/effect/turf_decal/corner/opaque/brown{
	dir = 1
	},
/turf/open/floor/wood,
/area/ship/bridge)
"hR" = (
/obj/structure/flora/ausbushes/brflowers,
/turf/open/floor/grass/fairy,
/turf/open/floor/grass/fairy,
/area/ship/bridge)
"iq" = (
/obj/effect/decal/cleanable/dirt/dust,
/obj/effect/decal/cleanable/dirt,
/obj/effect/decal/cleanable/dirt,
/obj/structure/closet/firecloset/full,
/turf/open/floor/plating,
/area/ship/maintenance/central)
"iC" = (
/obj/machinery/advanced_airlock_controller{
	pixel_y = 2;
	pixel_x = 32
	},
/turf/open/floor/plating/catwalk_floor,
/area/space)
"jg" = (
/turf/closed/wall/mineral/wood,
/area/space)
"kz" = (
/obj/effect/decal/cleanable/dirt/dust,
/obj/effect/decal/cleanable/dirt,
/obj/machinery/atmospherics/pipe/simple/supply/hidden/layer2{
	dir = 8
	},
/turf/open/floor/plating,
/area/ship/maintenance/central)
"lx" = (
/obj/structure/window/reinforced/fulltile,
/obj/machinery/door/poddoor/shutters{
	name = "Blast Shutters"
	},
/turf/open/floor/plating,
/area/ship/bridge)
"lC" = (
/turf/open/floor/grass/fairy,
/area/ship/bridge)
"nq" = (
/obj/effect/decal/cleanable/dirt,
/obj/machinery/atmospherics/pipe/simple/supply/hidden/layer2{
	dir = 8
	},
/turf/open/floor/plating,
/area/ship/maintenance/central)
"nA" = (
/turf/closed/wall/mineral/wood,
/area/ship/maintenance/central)
"on" = (
/obj/effect/decal/cleanable/dirt/dust,
/obj/effect/decal/cleanable/dirt,
/turf/open/floor/plating,
/area/ship/maintenance/central)
"qy" = (
/obj/structure/mirror{
	pixel_y = 2
	},
/turf/closed/wall/mineral/wood,
/area/ship/maintenance/central)
"se" = (
/obj/machinery/power/shuttle/engine/void,
/turf/open/space,
/area/ship/maintenance/central)
"sL" = (
/obj/effect/decal/cleanable/dirt/dust,
/obj/machinery/atmospherics/components/binary/pump/on/layer2{
	dir = 4
	},
/turf/open/floor/plating,
/area/ship/maintenance/central)
"tV" = (
/obj/effect/decal/cleanable/dirt/dust,
/obj/effect/decal/cleanable/dirt,
/obj/machinery/atmospherics/pipe/simple/supply/hidden/layer2{
	dir = 5
	},
/turf/open/floor/plating,
/area/ship/maintenance/central)
"uT" = (
/obj/structure/shuttle/engine/heater,
/obj/structure/window/reinforced/spawner/north{
	dir = 2
	},
/turf/open/floor/plating,
/area/ship/maintenance/central)
"vh" = (
/obj/effect/decal/cleanable/dirt/dust,
/turf/open/floor/plating,
/area/ship/maintenance/central)
"vr" = (
/obj/structure/flora/grass/brown,
/turf/open/floor/grass/fairy,
/area/ship/bridge)
"wj" = (
/obj/machinery/atmospherics/pipe/simple/supply/hidden/layer2{
	dir = 6
	},
/turf/open/floor/wood,
/area/ship/bridge)
"wn" = (
/obj/effect/decal/cleanable/dirt/dust,
/obj/effect/spawner/lootdrop/maintenance,
/obj/machinery/atmospherics/pipe/simple/supply/hidden/layer2{
	dir = 6
	},
/turf/open/floor/plating,
/area/ship/maintenance/central)
"wP" = (
/obj/machinery/atmospherics/components/unary/vent_pump/on/layer2{
	dir = 8
	},
/turf/open/floor/wood,
/area/ship/bridge)
"zP" = (
/obj/machinery/power/shuttle/engine/void,
/turf/open/space/basic,
/area/ship/maintenance/central)
"zS" = (
/obj/effect/decal/cleanable/dirt,
/obj/effect/decal/cleanable/dirt,
/obj/effect/decal/cleanable/dirt,
/obj/effect/decal/cleanable/dirt,
/obj/effect/decal/cleanable/dirt,
/obj/effect/decal/cleanable/dirt,
/turf/open/floor/plating,
/area/ship/maintenance/central)
"Bn" = (
/obj/structure/flora/grass/green,
/turf/open/floor/grass/fairy,
/area/ship/bridge)
"BF" = (
/turf/open/space,
/area/space)
"Dj" = (
/turf/closed/wall/mineral/wood,
/area/ship/bridge)
"DX" = (
/obj/effect/turf_decal/corner/opaque/brown{
	dir = 9
	},
/turf/open/floor/wood,
/area/ship/bridge)
"EQ" = (
/obj/structure/flora/grass/green,
/obj/machinery/atmospherics/pipe/simple/supply/hidden/layer2,
/turf/open/floor/grass/fairy,
/area/ship/bridge)
"Gc" = (
/obj/machinery/door/airlock/external,
/obj/effect/mapping_helpers/airlock/cyclelink_helper,
/turf/open/floor/plating,
/area/space)
"GY" = (
/obj/effect/decal/cleanable/dirt/dust,
/turf/closed/wall/mineral/wood,
/area/ship/maintenance/central)
"Hu" = (
/obj/effect/decal/cleanable/dirt/dust,
/obj/effect/decal/cleanable/dirt,
/obj/machinery/atmospherics/components/unary/tank/air,
/turf/open/floor/plating,
/area/ship/maintenance/central)
"HQ" = (
/obj/effect/decal/cleanable/dirt/dust,
/obj/effect/decal/cleanable/dirt,
/obj/structure/sink{
	pixel_y = 29
	},
/turf/open/floor/plating,
/area/ship/maintenance/central)
"Ip" = (
/obj/effect/decal/cleanable/dirt/dust,
/obj/effect/decal/cleanable/dirt,
/obj/effect/decal/cleanable/dirt,
/obj/structure/closet/crate,
/obj/structure/closet/crate,
/obj/structure/closet/crate,
/obj/item/mop/advanced,
/obj/item/reagent_containers/glass/bucket,
/turf/open/floor/plating,
/area/ship/maintenance/central)
"Ji" = (
/obj/effect/turf_decal/corner/opaque/brown{
	dir = 5
	},
/obj/effect/turf_decal/corner/opaque/brown,
/turf/open/floor/wood,
/area/ship/bridge)
"JA" = (
/obj/structure/flora/ausbushes/brflowers,
/obj/structure/sink/puddle,
/turf/open/floor/grass/fairy,
/area/ship/bridge)
"JE" = (
/obj/effect/decal/cleanable/dirt/dust,
/obj/effect/decal/cleanable/dirt,
/obj/effect/spawner/lootdrop/maintenance,
/turf/open/floor/plating,
/area/ship/maintenance/central)
"JO" = (
/obj/effect/decal/cleanable/dirt/dust,
/obj/effect/decal/cleanable/dirt/dust,
/obj/effect/decal/cleanable/dirt,
/turf/closed/wall/mineral/wood,
/area/ship/maintenance/central)
"Kd" = (
/obj/machinery/airalarm/all_access{
	dir = 8;
	pixel_x = 25
	},
/turf/open/floor/plating,
/area/space)
"KL" = (
/obj/effect/decal/cleanable/dirt,
/turf/open/floor/plating,
/area/ship/maintenance/central)
"Mk" = (
/obj/item/kirbyplants/photosynthetic,
/turf/open/floor/grass/fairy,
/area/ship/bridge)
"MM" = (
/obj/effect/decal/cleanable/dirt,
/obj/machinery/atmospherics/components/unary/vent_pump/on/layer2{
	dir = 8
	},
/turf/open/floor/plating,
/area/ship/maintenance/central)
"Ok" = (
/obj/effect/turf_decal/corner/opaque/brown{
	dir = 6
	},
/turf/open/floor/wood,
/area/ship/bridge)
"PK" = (
/obj/machinery/atmospherics/pipe/simple/supply/hidden/layer2{
	dir = 4
	},
/turf/open/floor/wood,
/area/ship/bridge)
"Qt" = (
/obj/machinery/door/airlock/external,
/obj/effect/mapping_helpers/airlock/cyclelink_helper{
	dir = 1
	},
/turf/open/floor/plating,
/area/space)
"Rf" = (
/turf/open/floor/wood,
/area/ship/bridge)
"RM" = (
/obj/effect/spawner/structure/window/reinforced/tinted,
/turf/open/floor/plasteel/tech/techmaint,
/area/ship/maintenance/central)
"RZ" = (
/turf/open/space/basic,
/area/space)
"Sg" = (
/turf/open/floor/plating/catwalk_floor,
/area/space)
"Tc" = (
/obj/effect/turf_decal/industrial/warning{
	dir = 9
	},
/obj/effect/turf_decal/industrial/warning{
	dir = 4
	},
/turf/open/floor/plasteel/tech,
/area/space)
"TN" = (
/obj/structure/flora/grass/both,
/turf/open/floor/grass/fairy,
/area/ship/bridge)
"TR" = (
/obj/structure/flora/grass/jungle/b,
/obj/effect/overlay/palmtree_l{
	pixel_y = 3
	},
/turf/open/floor/grass,
/area/ship/bridge)
"Vh" = (
/obj/effect/turf_decal/industrial/warning,
/obj/effect/turf_decal/industrial/warning{
	dir = 10
	},
/obj/effect/turf_decal/industrial/warning{
	dir = 4
	},
/turf/open/floor/plasteel/tech,
/area/space)
"Vz" = (
/obj/effect/turf_decal/corner/opaque/brown{
	dir = 4
	},
/turf/open/floor/wood,
/area/ship/bridge)
"Wq" = (
/obj/structure/window/reinforced/fulltile,
/obj/machinery/door/poddoor/shutters{
	name = "Blast Shutters";
	id = "treepodshutters"
	},
/turf/open/floor/plating,
/area/ship/bridge)
"Yg" = (
/obj/structure/flora/grass/jungle/b,
/obj/structure/flora/tree/palm{
	pixel_x = 4;
	pixel_y = 21
	},
/turf/open/floor/grass,
/area/ship/bridge)
"YE" = (
/obj/machinery/atmospherics/pipe/simple/supply/hidden/layer2,
/turf/open/floor/wood,
/area/ship/bridge)
"YW" = (
/obj/machinery/door/airlock/wood,
/obj/machinery/atmospherics/pipe/simple/supply/hidden/layer2,
/turf/open/floor/plasteel/tech/techmaint,
/area/ship/maintenance/central)
"ZK" = (
/obj/effect/decal/cleanable/dirt/dust,
/obj/effect/decal/cleanable/dirt,
/obj/machinery/atmospherics/pipe/simple/supply/hidden/layer2{
	dir = 4
	},
/turf/open/floor/plating,
/area/ship/maintenance/central)
"ZT" = (
/obj/effect/turf_decal/corner/opaque/brown{
	dir = 5
	},
/turf/open/floor/wood,
/area/ship/bridge)

(1,1,1) = {"
BF
BF
BF
BF
BF
BF
BF
BF
BF
BF
BF
BF
BF
BF
BF
BF
BF
BF
BF
BF
BF
BF
BF
BF
BF
BF
BF
BF
BF
BF
"}
(2,1,1) = {"
BF
BF
BF
BF
BF
BF
BF
BF
BF
BF
BF
BF
BF
BF
BF
BF
BF
BF
BF
BF
BF
BF
BF
BF
BF
BF
BF
BF
BF
BF
"}
(3,1,1) = {"
BF
BF
BF
BF
BF
BF
BF
BF
BF
BF
BF
BF
BF
BF
BF
BF
BF
BF
BF
BF
BF
BF
BF
BF
BF
BF
BF
BF
BF
BF
"}
(4,1,1) = {"
BF
BF
BF
BF
BF
BF
BF
BF
BF
BF
BF
BF
BF
BF
BF
BF
BF
BF
BF
BF
BF
BF
BF
BF
BF
BF
BF
BF
BF
BF
"}
(5,1,1) = {"
BF
BF
BF
BF
BF
BF
BF
BF
BF
BF
BF
BF
BF
BF
BF
BF
BF
BF
BF
BF
BF
BF
BF
BF
BF
BF
BF
BF
BF
BF
"}
(6,1,1) = {"
BF
BF
BF
BF
BF
BF
BF
BF
BF
BF
BF
BF
BF
BF
BF
BF
BF
BF
BF
BF
BF
BF
BF
BF
BF
BF
BF
BF
BF
BF
"}
(7,1,1) = {"
BF
BF
BF
BF
BF
BF
BF
BF
BF
BF
BF
BF
BF
BF
BF
BF
BF
BF
BF
BF
BF
BF
BF
BF
BF
BF
BF
BF
BF
BF
"}
(8,1,1) = {"
BF
BF
BF
BF
BF
BF
BF
BF
BF
BF
BF
BF
BF
BF
BF
BF
BF
BF
BF
BF
BF
BF
BF
BF
BF
BF
BF
BF
BF
BF
"}
(9,1,1) = {"
BF
BF
BF
BF
BF
BF
BF
BF
BF
BF
BF
BF
BF
BF
BF
BF
BF
BF
BF
BF
BF
BF
BF
BF
BF
BF
BF
BF
BF
BF
"}
(10,1,1) = {"
BF
BF
BF
BF
BF
BF
BF
BF
BF
BF
BF
BF
BF
BF
BF
BF
BF
BF
BF
BF
BF
BF
BF
BF
BF
BF
BF
BF
BF
BF
"}
(11,1,1) = {"
BF
BF
BF
BF
BF
BF
BF
BF
BF
BF
BF
BF
BF
BF
BF
BF
BF
BF
BF
BF
BF
BF
BF
BF
BF
BF
BF
BF
BF
BF
"}
(12,1,1) = {"
BF
BF
BF
BF
BF
BF
BF
BF
BF
Dj
Dj
lx
lx
Dj
Dj
nA
nA
nA
nA
RZ
BF
BF
BF
BF
BF
BF
BF
BF
BF
BF
"}
(13,1,1) = {"
BF
BF
BF
BF
BF
BF
BF
BF
Dj
Dj
cd
DX
DX
hR
Yg
nA
wn
Hu
uT
zP
BF
BF
BF
BF
BF
BF
BF
BF
BF
BF
"}
(14,1,1) = {"
BF
BF
BF
BF
BF
BF
BF
BF
Dj
ce
fi
Rf
Rf
TN
JA
nA
sL
Ip
nA
jg
jg
jg
BF
BF
BF
BF
BF
BF
BF
BF
"}
(15,1,1) = {"
BF
BF
BF
BF
BF
BF
BF
BF
Dj
ZT
Rf
Rf
Rf
ba
vr
nA
dU
tV
nA
fK
fK
jg
jg
jg
jg
BF
BF
BF
BF
BF
"}
(16,1,1) = {"
BF
BF
BF
BF
BF
BF
BF
BF
lx
ZT
Rf
Rf
Rf
Rf
TN
RM
ZK
kz
JO
fK
fK
jg
fX
Sg
jg
BF
BF
BF
BF
BF
"}
(17,1,1) = {"
BF
BF
BF
BF
BF
BF
BF
BF
Wq
ZT
Rf
wj
YE
YE
EQ
YW
ac
nq
zS
fK
fK
Gc
Tc
Vh
Qt
BF
BF
BF
BF
BF
"}
(18,1,1) = {"
BF
BF
BF
BF
BF
BF
BF
BF
Wq
ZT
Rf
PK
Rf
ba
lC
RM
KL
MM
nA
fK
fK
jg
Sg
iC
jg
BF
BF
BF
BF
BF
"}
(19,1,1) = {"
BF
BF
BF
BF
BF
BF
BF
BF
Dj
ZT
Rf
PK
Rf
TR
Bn
nA
vh
on
GY
Kd
fK
jg
jg
jg
jg
BF
BF
BF
BF
BF
"}
(20,1,1) = {"
BF
BF
BF
BF
BF
BF
BF
BF
Dj
Ji
Vz
wP
Rf
Rf
cN
qy
HQ
on
nA
jg
jg
jg
BF
BF
BF
BF
BF
BF
BF
BF
"}
(21,1,1) = {"
BF
BF
BF
BF
BF
BF
BF
BF
Dj
Dj
ge
Ok
Ok
vr
Mk
nA
iq
JE
uT
se
BF
BF
BF
BF
BF
BF
BF
BF
BF
BF
"}
(22,1,1) = {"
BF
BF
BF
BF
BF
BF
BF
BF
BF
Dj
Dj
lx
Wq
Dj
Dj
nA
nA
nA
nA
BF
BF
BF
BF
BF
BF
BF
BF
BF
BF
BF
"}
(23,1,1) = {"
BF
BF
BF
BF
BF
BF
BF
BF
BF
BF
BF
BF
BF
BF
BF
BF
BF
BF
BF
BF
BF
BF
BF
RZ
BF
BF
BF
BF
BF
BF
"}
(24,1,1) = {"
BF
BF
BF
BF
BF
BF
BF
BF
BF
BF
BF
BF
BF
BF
BF
BF
BF
BF
BF
BF
BF
BF
BF
BF
BF
BF
BF
BF
BF
BF
"}
(25,1,1) = {"
BF
BF
BF
BF
BF
BF
BF
BF
BF
BF
BF
BF
BF
BF
BF
BF
BF
BF
BF
BF
BF
BF
BF
BF
BF
BF
BF
BF
BF
BF
"}
(26,1,1) = {"
BF
BF
BF
BF
BF
BF
BF
BF
BF
BF
BF
BF
BF
BF
BF
BF
BF
BF
RZ
BF
BF
BF
BF
BF
BF
BF
BF
BF
BF
BF
"}
(27,1,1) = {"
BF
BF
BF
BF
BF
BF
BF
BF
BF
BF
BF
BF
BF
BF
BF
BF
BF
BF
BF
BF
BF
BF
BF
BF
BF
BF
BF
BF
BF
BF
"}
(28,1,1) = {"
BF
BF
BF
BF
BF
BF
BF
BF
BF
BF
BF
BF
BF
BF
BF
BF
BF
BF
BF
BF
BF
BF
BF
BF
BF
BF
BF
BF
BF
BF
"}
(29,1,1) = {"
BF
BF
BF
BF
BF
BF
BF
BF
BF
BF
BF
BF
BF
BF
BF
BF
BF
BF
BF
BF
BF
BF
BF
BF
BF
BF
BF
BF
BF
BF
"}
(30,1,1) = {"
BF
BF
BF
BF
BF
BF
BF
BF
BF
BF
BF
BF
BF
BF
BF
BF
BF
BF
BF
BF
BF
BF
BF
BF
BF
BF
BF
BF
BF
BF
"}
